#######################################
# Syntax Coloring Map For Grow
#######################################

#######################################
# Datatypes (KEYWORD1)
#######################################

Day	KEYWORD1
MultiDay	KEYWORD1
LED	KEYWORD1
Actuator	KEYWORD1
actuator	KEYWORD1
solenoidValve	KEYWORD1
analogSensor	KEYWORD1
UltraSonic	KEYWORD1
sensor	KEYWORD1
controllerHVAC	KEYWORD1
compressorController	KEYWORD1
recirculationController	KEYWORD1
growerStepper	KEYWORD1

#######################################
# Methods and Functions (KEYWORD2)
#######################################

toFloat	KEYWORD2

changeDayHour	KEYWORD2
changeNightHour	KEYWORD2
changeHours	KEYWORD2
redefine	KEYWORD2
changeState	KEYWORD2
setState	KEYWORD2
getState	KEYWORD2
turnOn	KEYWORD2
turnOff	KEYWORD2
setTimeOn	KEYWORD2
setTimeOff	KEYWORD2
setTime	KEYWORD2
getTimeOn	KEYWORD2
getTimeOff	KEYWORD2
getTime	KEYWORD2
enable	KEYWORD2
disable	KEYWORD2
isEnable	KEYWORD2
setCycleTime	KEYWORD2
getGroup	KEYWORD2
getOrder	KEYWORD2
getTimeOn	KEYWORD2
getCycleTime	KEYWORD2
getName	KEYWORD2
changeGroup	KEYWORD2
changeOrderNumber	KEYWORD2
reOrder	KEYWORD2
getActualNumber	KEYWORD2
getFloor	KEYWORD2
getRegion	KEYWORD2
reOrderAll	KEYWORD2
reOrder_byFloor	KEYWORD2
defaultOrder	KEYWORD2
restartH2O	KEYWORD2
restartAllH2O	KEYWORD2
printH2O	KEYWORD2
printAllH2O	KEYWORD2
getH2O	KEYWORD2
setModel	KEYWORD2
notFilter	KEYWORD2
defaultFilter	KEYWORD2
setExponentialFilter	KEYWORD2
setKalmanFilter	KEYWORD2
getPreValue	KEYWORD2
getValue	KEYWORD2
printModel	KEYWORD2
printFilter	KEYWORD2
testing	KEYWORD2
read	KEYWORD2
flowSensorBegin	KEYWORD2
getHR_State	KEYWORD2
getCC_State	KEYWORD2
getFR_State	KEYWORD2
getCVC_State	KEYWORD2
getCVH_State	KEYWORD2
getWarn_State	KEYWORD2
getWork_State	KEYWORD2
changeMode	KEYWORD2
changeFan	KEYWORD2
begin	KEYWORD2
run	KEYWORD2
getState_In1	KEYWORD2
getState_In2	KEYWORD2
getState_In3	KEYWORD2
getState_In4	KEYWORD2
getState_In5	KEYWORD2
getState_Out1	KEYWORD2
getState_Out2	KEYWORD2
getState_Out3	KEYWORD2
getState_Out4	KEYWORD2
getState_Out5	KEYWORD2
getState_InPump	KEYWORD2
getState_OutPump	KEYWORD2
getLiters	KEYWORD2
getLiters1	KEYWORD2
getLiters2	KEYWORD2
getLiters3	KEYWORD2
getLiters4	KEYWORD2
getLiters5	KEYWORD2
setIn	KEYWORD2
setOut	KEYWORD2
turnOn_OutPump	KEYWORD2
turnOn_InPump	KEYWORD2
read_LevelSwitch	KEYWORD2
getValveCompressorState	KEYWORD2
getValveNutritionState	KEYWORD2
getValveWaterState	KEYWORD2
close_ValveNutrition	KEYWORD2
close_ValveWater	KEYWORD2
setMode	KEYWORD2
beginAll	KEYWORD2
changeMinDist	KEYWORD2
changeMaxDist	KEYWORD2
readAndPrint	KEYWORD2
runAll	KEYWORD2
getXPosition	KEYWORD2
getYPosition	KEYWORD2
setMaxDistanceX	KEYWORD2
setMaxDistanceY	KEYWORD2
getMaxDistanceX	KEYWORD2
getMaxDistanceY	KEYWORD2
moveX	KEYWORD2
moveY	KEYWORD2
moveXTo	KEYWORD2
moveYTo	KEYWORD2
calibration	KEYWORD2
isAvailable	KEYWORD2
isInCalibration	KEYWORD2
continueSequence	KEYWORD2
stopSequence	KEYWORD2
sequence	KEYWORD2
home	KEYWORD2

#######################################
# Constants (LITERAL1)
#######################################
MAX_ACTUATORS_GROUPS	LITERAL1
MAX_ACTUATORS	LITERAL1
MAX_FLOOR	LITERAL1
MAX_IRRIGATION_REGIONS	LITERAL1
MAX_EQUATION_DEGREE	LITERAL1
AUTO_FAN	LITERAL1
ON_FAN	LITERAL1
OFF_MODE	LITERAL1
COOL_MODE	LITERAL1
HEAT_MODE	LITERAL1
PIN_LEVEL_0	LITERAL1
PIN_LEVEL_1	LITERAL1
PIN_LEVEL_2	LITERAL1
PIN_LEVEL_3	LITERAL1
PIN_LEVEL_4	LITERAL1
PIN_LEVEL_5	LITERAL1
NAME_LEVEL_0	LITERAL1
NAME_LEVEL_1	LITERAL1
NAME_LEVEL_2	LITERAL1
NAME_LEVEL_3	LITERAL1
NAME_LEVEL_4	LITERAL1
NAME_LEVEL_5	LITERAL1
PIN_LEVEL_SWITCH	LITERAL1
DEFAULT_MAX_X_DISTANCE_MM	LITERAL1
DEFAULT_MAX_Y_DISTANCE_MM	LITERAL1